1111111111111111111111111111111111111111111111111111111111111111111111111111111111111111111111111111111111111111222222222211111111111111111111111111111111111111
1111110000000000000000011111110000000000000000000000112121100000000000000000000002222222220000000000000000000000022222222222200000000000000000000000000000011111
1100000000000000000000001110000000000000000000000000011210000000000000000000000000111111100000000000000000000000000222222220000000000000000000000000000000000111
1000000000000000000000000100000000000000000000000000001210000000000000000000000000011112000000000000000000000000000111110000000000000000000000000000000000000011
1000000000000000000000001100000000000000000000000000000120000000000000000000000000001112000000000000000000000000000111110000000000000000000000000000000000000001
1000000000000000000000001000000000000000000000000000000002000000000000000000000000000011200000000000000000000000000011100000000000000000000000000000000000000001
0000000222222222000000000000000000000000000000000000000020000000000000000000000000000011000000000000000000000000000111000000000000000000000000000000000000000001
0000000000000000000000000000000000000000000000000000000000000000000000000000000000000001000000000000000000000000000110000000000000000000000000000000000000000001
0000000000000000000000000000000000000000000000000000000000000000000000000000000000000000000000000000000000000000000010000000000000000000000000000000000000000000
0000000000000000000000000000000000000000000000000000000000000000000000000000000000000000000000000000000000222200000000000000000000000000000000000000000000000000
0000000000000000000000000000000000000000000000000000000000000000000002222200000000000000000000000000000000000000000000000000000000000000000000000000000000000000
0000000000000000000222220000000000000000000003222000000000000000000000000000000000000000000000000000000000000000000000000000000000000000000000000000000000000000
0000000000000000000000000000000000000000000002112000000000000000000000000000000000000000000000000000000000000000000000000000000000000000000000000000000000000000
0000000000000000000000000000000000000000000002112000000000000000000000000000000000000000000000000000000000000000000000000000000000000000000000000000000000000000
0000000000000000000000000000000000000000000002112000000000000000000000000000000000000000000000000000000000000000000000002222220000000000000000000000000000000000
0000000002222200000000000000000000000000000002112000000000000000000000000000000222222200000000000000000000000000000000000000000000000000000000000000000000000000
0000000000000000000000000000000000000000000002112000000000000000000000000000000000000000000000000000000000000000000000000000000000000000000000000000000000000000
0000000000000000000000000000000000000000000002112000000000222222222000000000000000000000000000000000000000000000000000000000000000000000000000000000000000000000
0000000000000022200000000000000000000000000002112000000000000000000000000000000000000000000000000000000000000000000000000000000000000000000000000000000000000000
0000000000000000000000000000000000000000000002112000000000000000000000000000000000000000000000000000000000000000000000000000000000000000000000000000000000000000
0000000000000000000000000000000000000000000002110000000000000000000000000000000000000000000000000000000022200000000000000000000000000000000000000000000000000000
0000222222000000000000000000000000000000000002110000000000000000000000000000000000002200000000000000000000000000000000000000000200000000000000000000000000000000
0000000000000000000000000000000000000000000002110000000000000000000000000000000000000000000000000000000000000000000000000000000200000000000000000000000000000000
0000000000000000000322400000000000000000000002110000000000000000000000000000200000000000000000000000000000000000000000000000000220000000000000000000000000000000
0200000000000000003222400000000000000000000002100000000000000000000000000000200000000000000000000000000000000000000000000000002200000000000000000000000000000000
1320000000000000032222400000000000000000000032100000000000000000000000000000220000000000000000000000000000000000000000000000022200000000000000000000000000000000
133200000000000032222240000000000000000000033211240000000000000000000000000222000000000000000000000000000000000000000000000022222000000000000000000000000000000p
1222222222222222222222222222222000000022222222112222222222222222222222222222222222222222200000000002222222222222222222222222222222222222222222222222222222222222
1111111111111111111111111111111400000311111111111111111111111111111111111111111111111111100000000001111111111111111111111111111111111111111111111111111111111111
1111111111111111111111111111111100000111111111111111111111111111111111111111111111111111100000000001111111111111111111111111111111111111111111111111111111111111
1111111111111111111111111111111100000111111111111111111111111111111111111111111111111111100000000001111111111111111111111111111111111111111111111111111111111111
1111111111111111111111111111111100000111111111111111111111111111111111111111111111111111100000000001111111111111111111111111111111111111111111111111111111111111
1111111111111111111111111111111100000111111111111111111111111111111111111111111111111111100000000001111111111111111111111111111111111111111111111111111111111111
1111111111111111111111111111111100000111111111111111111111111111111111111111111111111111100000000001111111111111111111111111111111111111111111111111111111111111
1111111111111111111111111111111100000111111111111111111111111111111111111111111111111111100000000001111111111111111111111111111111111111111111111111111111111111
1111111111111111111111111111111100000111111111111111111111111111111111111111111111111111100000000001111111111111111111111111111111111111111111111111111111111111
1111111111111111111111111111111100000111111111111111111111111111111111111111111111111111100000000001111111111111111111111111111111111111111111111111111111111111
1111111111111111111111111111111100000111111111111111111111111111111111111111111111111111100000000001111111111111111111111111111111111111111111111111111111111111
1111111111111111111111111111111100000111111111111111111111111111111111111111111111111111100000000001111111111111111111111111111111111111111111111111111111111111
1111111111111111111111111111111100000111111111111111111111111111111111111111111111111111100000000001111111111111111111111111111111111111111111111111111111111111