000000000000000000000000000000000000000000
550000000000000000000000000000000000000055
5500^005555555555555555555555555555555555
550000005555555555555555555555555555555555
550000000000000000000000000000000000000q65
550000000000000000000000000000000000000a65
550000000000000000000s00000000000000^00y65
555555555555555555555555555555555500000y65
555555555555555555555555555555555500000y65
550000000000000000000000000000000000000a65
550000000000000000000000000000000000000a65
5500000000s0000000000000000000000000000n65
550000005555555555555555555555555555555555
550000005555555555555555555555555555555555
550000000000000000000000000000000000000q65
550000000000000000000000000000000000000y65
550000s000000000000000000000s0000000000065
555555555555555555555555555555555500000m65
555555555555555555555555555555555500000m65
558000000000000000000000000000000000000y65
55y000000000000000000000000000000000000y65
55y00000000000s000000000000000000s00000n65
55y000005555555555555555555555555555555555
55y000005555555555555555555555555555555555
55y000000000000000000000000000000000bbb865
55y000000000000000000000000000000000zbby65
55t0s000000000000000000s0000000000000zby65
55555555555555555555555555555555550000zy65
55555555555555555555555555555555550000zy65
55800000000000000000000000000000000000dy65
55b000000000000000000000000000000000000y65
55b000000000s00000000000000000000000000t65
55b000005555555555555555555555555555555555
55b000005555555555555555555555555555555555
55m000000000000000000000000000000000000865
55y000000000000000000000000000000000000y65
55t0000000000000000000000000000s0000000y65
55555555555555ffff555555555555555500000y65
555555555555555555555555555555555500000y65
558000000000000000000000000000000000000y65
55a000000000000000000000000000000000000y65
55y000000000000000000000s000000000000s0n65
55y0000055555555555555555555wwww5555555565
55y000005555555555555555555555555555555555
55af00000000000000000000000000000000000065
55ybf0000000000000000000000000000000000065
55tbbf000000000000000000000000000000000065
5555555555555555555555555ooo55555500000065
555555555555555555555555555555555500000065
55q000000000000000000000000000000000000065
55m000000000000000000000000000000000000065
55n000000000000000000000000000000000000065
55555555555555555555555555555555555555555555555555555555555555555555555555555555555
55555555555555555555555555555555555555555555555555555555555555555555555555555555555
55555555555555555555555555555555555555555555555555555555555555555555555555555555555
55555555555555555555555555555555555555555555555555555555555555555555555555555555555